"","cal_yr","gp","country","npos","nneg","nneu","nmention","log_senti","add_senti"
"1",2020,"OTHER","Croatia",23925,6078,25622,55625,1.37018688074852,0.320844943820225
"2",2020,"USA","Croatia",46,2,36,84,2.92316158071916,0.523809523809524
"3",2020,"DE","Croatia",104,1,65,170,4.2437219632967,0.605882352941176
"4",2020,"RU","Croatia",22,0,8,30,3.80666248977032,0.733333333333333
"5",2020,"CN","Croatia",43,1,40,84,3.36729582998647,0.5
"6",2020,"FR","Croatia",47,0,24,71,4.55387689160054,0.661971830985915
"7",2020,"UK","Croatia",8,1,6,15,1.73460105538811,0.466666666666667
"8",2019,"OTHER","Croatia",47695,13430,50864,111989,1.26730881389736,0.305967550384413
"9",2019,"DE","Croatia",237,6,124,367,3.5983654465731,0.629427792915531
"10",2019,"FR","Croatia",56,0,30,86,4.72738781871234,0.651162790697674
"11",2019,"UK","Croatia",75,1,58,134,3.91866754814681,0.552238805970149
"12",2019,"USA","Croatia",57,1,52,110,3.64631983969514,0.509090909090909
"13",2019,"RU","Croatia",90,0,35,125,5.19849703126583,0.72
"14",2019,"CN","Croatia",69,2,40,111,3.32503602069659,0.603603603603604
"15",2018,"OTHER","Croatia",56434,18309,58199,132942,1.12566062278687,0.286779196943028
"16",2018,"FR","Croatia",60,1,43,104,3.69717825692863,0.567307692307692
"17",2018,"DE","Croatia",246,5,115,366,3.80261390124432,0.658469945355191
"18",2018,"CN","Croatia",37,1,28,66,3.2188758248682,0.545454545454545
"19",2018,"RU","Croatia",105,4,69,178,3.15463355613985,0.567415730337079
"20",2018,"USA","Croatia",92,3,51,146,3.27444567602301,0.60958904109589
"21",2018,"UK","Croatia",41,3,17,61,2.47293045874128,0.622950819672131
"22",2017,"OTHER","Croatia",63090,15567,55092,133749,1.39938479577309,0.355314806092008
"23",2017,"FR","Croatia",71,1,35,107,3.8642323415918,0.654205607476635
"24",2017,"DE","Croatia",271,5,118,394,3.89921404713556,0.6751269035533
"25",2017,"USA","Croatia",71,1,47,119,3.8642323415918,0.588235294117647
"26",2017,"UK","Croatia",65,0,24,89,4.87519732320115,0.730337078651685
"27",2017,"RU","Croatia",119,0,55,174,5.47646355193151,0.683908045977011
"28",2017,"CN","Croatia",34,0,11,45,4.23410650459726,0.755555555555556
"29",2016,"OTHER","Croatia",31233,8240,30060,69533,1.33243021504923,0.330677520026462
"30",2016,"USA","Croatia",29,1,18,48,2.97892515523761,0.583333333333333
"31",2016,"RU","Croatia",55,1,22,78,3.61091791264422,0.692307692307692
"32",2016,"FR","Croatia",41,0,21,62,4.4188406077966,0.661290322580645
"33",2016,"UK","Croatia",22,0,11,33,3.80666248977032,0.666666666666667
"34",2016,"CN","Croatia",6,0,4,10,2.56494935746154,0.6
"35",2016,"DE","Croatia",101,0,49,150,5.31320597904179,0.673333333333333
"36",2015,"OTHER","Croatia",34800,12256,30768,77824,1.04357534598257,0.289679276315789
"37",2015,"UK","Croatia",25,1,21,47,2.83321334405622,0.51063829787234
"38",2015,"FR","Croatia",53,0,19,72,4.67282883446191,0.736111111111111
"39",2015,"DE","Croatia",181,6,49,236,3.32945347680331,0.741525423728814
"40",2015,"USA","Croatia",46,2,13,61,2.92316158071916,0.721311475409836
"41",2015,"CN","Croatia",20,0,11,31,3.71357206670431,0.645161290322581
"42",2015,"RU","Croatia",32,2,4,38,2.56494935746154,0.789473684210526
"43",2014,"OTHER","Croatia",42362,16605,42924,101891,0.936529571145574,0.252789745904938
"44",2014,"DE","Croatia",170,8,92,270,2.9986691332273,0.6
"45",2014,"RU","Croatia",39,1,15,55,3.27083556379891,0.690909090909091
"46",2014,"FR","Croatia",71,1,39,111,3.8642323415918,0.630630630630631
"47",2014,"CN","Croatia",20,0,10,30,3.71357206670431,0.666666666666667
"48",2014,"USA","Croatia",40,3,34,77,2.44853900561713,0.480519480519481
"49",2014,"UK","Croatia",32,0,17,49,4.17438726989564,0.653061224489796
"50",2013,"OTHER","Croatia",48239,20240,49493,117972,0.868492639851311,0.237335978028685
"51",2013,"RU","Croatia",51,0,18,69,4.63472898822964,0.739130434782609
"52",2013,"DE","Croatia",256,9,127,392,3.29583686600433,0.630102040816326
"53",2013,"FR","Croatia",79,2,64,145,3.45946628978613,0.531034482758621
"54",2013,"UK","Croatia",31,0,11,42,4.14313472639153,0.738095238095238
"55",2013,"USA","Croatia",47,1,26,74,3.45526460293243,0.621621621621622
"56",2013,"CN","Croatia",40,0,6,46,4.39444915467244,0.869565217391304
"57",2012,"OTHER","Croatia",30871,14743,36359,81973,0.739031120505831,0.196747709611701
"58",2012,"DE","Croatia",107,4,59,170,3.17341345079144,0.605882352941176
"59",2012,"USA","Croatia",25,5,22,52,1.53393035992596,0.384615384615385
"60",2012,"UK","Croatia",10,0,12,22,3.04452243772342,0.454545454545455
"61",2012,"RU","Croatia",17,0,3,20,3.55534806148941,0.85
"62",2012,"CN","Croatia",24,4,10,38,1.69459572077441,0.526315789473684
"63",2012,"FR","Croatia",40,0,19,59,4.39444915467244,0.677966101694915
"64",2011,"OTHER","Croatia",18431,10915,32140,61486,0.523877359936319,0.122239208925609
"65",2011,"DE","Croatia",38,5,17,60,1.94591014905531,0.55
"66",2011,"RU","Croatia",12,1,18,31,2.12026353620009,0.354838709677419
"67",2011,"FR","Croatia",15,0,32,47,3.43398720448515,0.319148936170213
"68",2011,"USA","Croatia",14,2,25,41,1.75785791755237,0.292682926829268
"69",2011,"UK","Croatia",10,1,4,15,1.94591014905531,0.6
"70",2011,"CN","Croatia",8,0,3,11,2.83321334405622,0.727272727272727
"71",2010,"OTHER","Croatia",22281,14951,35279,72511,0.398945108496285,0.101088110769401
"72",2010,"FR","Croatia",15,0,21,36,3.43398720448515,0.416666666666667
"73",2010,"CN","Croatia",6,3,2,11,0.619039208406224,0.272727272727273
"74",2010,"USA","Croatia",30,3,31,64,2.164963715118,0.421875
"75",2010,"DE","Croatia",38,9,73,120,1.39936644268724,0.241666666666667
"76",2010,"RU","Croatia",21,1,17,39,2.66258782702545,0.512820512820513
"77",2010,"UK","Croatia",4,1,7,12,1.09861228866811,0.25
"78",2009,"OTHER","Croatia",21035,16071,35829,72935,0.269163969643552,0.0680606019058065
"79",2009,"FR","Croatia",28,2,33,63,2.43361335540045,0.412698412698413
"80",2009,"DE","Croatia",68,12,49,129,1.70110510095992,0.434108527131783
"81",2009,"USA","Croatia",41,8,42,91,1.58562726374038,0.362637362637363
"82",2009,"UK","Croatia",7,1,12,20,1.6094379124341,0.3
"83",2009,"CN","Croatia",15,2,4,21,1.82454929205105,0.619047619047619
"84",2009,"RU","Croatia",21,1,10,32,2.66258782702545,0.625
"85",2008,"OTHER","Croatia",18005,17890,40654,76549,0.0064074210744322,0.00150230571268077
"86",2008,"FR","Croatia",23,1,63,87,2.75153531304195,0.252873563218391
"87",2008,"DE","Croatia",60,12,42,114,1.57691472072854,0.421052631578947
"88",2008,"RU","Croatia",9,2,8,19,1.33500106673234,0.368421052631579
"89",2008,"UK","Croatia",8,1,6,15,1.73460105538811,0.466666666666667
"90",2008,"USA","Croatia",24,2,42,68,2.28238238567653,0.323529411764706
"91",2008,"CN","Croatia",17,1,8,26,2.4567357728213,0.615384615384615
"92",2007,"OTHER","Croatia",13703,10325,22815,46843,0.283034710833884,0.0721132292978673
"93",2007,"CN","Croatia",13,2,8,23,1.68639895357023,0.478260869565217
"94",2007,"UK","Croatia",7,0,11,18,2.70805020110221,0.388888888888889
"95",2007,"USA","Croatia",24,1,36,61,2.79320800944252,0.377049180327869
"96",2007,"FR","Croatia",10,1,7,18,1.94591014905531,0.5
"97",2007,"DE","Croatia",22,9,42,73,0.862223510603879,0.178082191780822
"98",2007,"RU","Croatia",19,1,21,41,2.56494935746154,0.439024390243902
"99",2006,"OTHER","Croatia",22266,15549,34318,72133,0.359054823049092,0.093119653972523
"100",2006,"FR","Croatia",29,0,12,41,4.07753744390572,0.707317073170732
"101",2006,"DE","Croatia",46,6,36,88,1.96765013569172,0.454545454545455
"102",2006,"UK","Croatia",10,1,8,19,1.94591014905531,0.473684210526316
"103",2006,"USA","Croatia",29,2,34,65,2.46809953147162,0.415384615384615
"104",2006,"CN","Croatia",10,0,6,16,3.04452243772342,0.625
"105",2006,"RU","Croatia",12,1,9,22,2.12026353620009,0.5
"106",2005,"OTHER","Croatia",22149,13174,32605,67928,0.519531779829787,0.132125191379107
"107",2005,"DE","Croatia",37,4,25,66,2.12026353620009,0.5
"108",2005,"USA","Croatia",40,3,63,106,2.44853900561713,0.349056603773585
"109",2005,"CN","Croatia",7,2,3,12,1.09861228866811,0.416666666666667
"110",2005,"FR","Croatia",16,1,8,25,2.39789527279837,0.6
"111",2005,"RU","Croatia",14,0,7,21,3.36729582998647,0.666666666666667
"112",2005,"UK","Croatia",13,0,7,20,3.29583686600433,0.65
"113",2004,"OTHER","Croatia",24789,15603,37067,77459,0.4629249283554,0.118591771130534
"114",2004,"DE","Croatia",26,5,31,62,1.57239664075375,0.338709677419355
"115",2004,"RU","Croatia",17,0,7,24,3.55534806148941,0.708333333333333
"116",2004,"FR","Croatia",27,0,15,42,4.00733318523247,0.642857142857143
"117",2004,"USA","Croatia",29,1,43,73,2.97892515523761,0.383561643835616
"118",2004,"CN","Croatia",7,2,4,13,1.09861228866811,0.384615384615385
"119",2004,"UK","Croatia",7,0,3,10,2.70805020110221,0.7
"120",2003,"OTHER","Croatia",139,226,728,1093,-0.484680343661668,-0.0795974382433669
"121",2003,"DE","Croatia",0,0,1,1,0,0
