"","cal_yr","gp","country","npos","nneg","nneu","nmention","log_senti","add_senti"
"1",1993,"OTHER","Czechia",6693,19010,23148,48851,-1.04385455185698,-0.252134040244826
"2",1993,"RU","Czechia",24,20,23,67,0.178248231406319,0.0597014925373134
"3",1993,"DE","Czechia",31,70,109,210,-0.805625163986636,-0.185714285714286
"4",1993,"USA","Czechia",14,16,33,63,-0.129211731480006,-0.0317460317460317
"5",1993,"FR","Czechia",7,3,24,34,0.762140052046897,0.117647058823529
"6",1993,"CN","Czechia",2,1,1,4,0.510825623765991,0.25
"7",1993,"UK","Czechia",9,8,21,38,0.111225635110224,0.0263157894736842
"8",1994,"OTHER","Czechia",5355,15066,18230,38651,-1.03434966593944,-0.251248350624822
"9",1994,"USA","Czechia",14,14,37,65,0,0
"10",1994,"FR","Czechia",1,0,17,18,1.09861228866811,0.0555555555555556
"11",1994,"DE","Czechia",30,31,51,112,-0.0322608622182214,-0.00892857142857143
"12",1994,"RU","Czechia",17,8,20,45,0.722134717433197,0.2
"13",1994,"UK","Czechia",7,5,13,25,0.310154928303839,0.08
"14",1994,"CN","Czechia",2,3,4,9,-0.336472236621213,-0.111111111111111
"15",1995,"OTHER","Czechia",5862,18308,22459,46629,-1.13878929911144,-0.266915438889961
"16",1995,"USA","Czechia",18,21,45,84,-0.150282203049338,-0.0357142857142857
"17",1995,"DE","Czechia",35,57,98,190,-0.482252251321935,-0.115789473684211
"18",1995,"FR","Czechia",12,19,30,61,-0.444685821261446,-0.114754098360656
"19",1995,"RU","Czechia",57,30,90,177,0.634058264189939,0.152542372881356
"20",1995,"UK","Czechia",10,10,13,33,0,0
"21",1995,"CN","Czechia",7,8,6,21,-0.125163142954006,-0.0476190476190476
"22",1996,"OTHER","Czechia",5701,18797,22718,47216,-1.19299458415477,-0.277363605557438
"23",1996,"RU","Czechia",21,18,20,59,0.150282203049338,0.0508474576271186
"24",1996,"DE","Czechia",34,63,91,188,-0.610080581861332,-0.154255319148936
"25",1996,"USA","Czechia",24,24,67,115,0,0
"26",1996,"UK","Czechia",15,14,33,62,0.0666913744986721,0.0161290322580645
"27",1996,"FR","Czechia",19,3,296,318,1.71765149707433,0.050314465408805
"28",1996,"CN","Czechia",9,9,10,28,0,0
"29",1997,"OTHER","Czechia",13740,31718,36272,81730,-0.836552430637709,-0.219968187935886
"30",1997,"FR","Czechia",65,19,91,175,1.21163567707151,0.262857142857143
"31",1997,"DE","Czechia",229,336,387,952,-0.382695119584183,-0.112394957983193
"32",1997,"CN","Czechia",26,17,15,58,0.414943852062708,0.155172413793103
"33",1997,"USA","Czechia",45,33,115,193,0.306166887125884,0.0621761658031088
"34",1997,"UK","Czechia",44,35,52,131,0.225956492690824,0.0687022900763359
"35",1997,"RU","Czechia",65,51,62,178,0.240468334971516,0.0786516853932584
"36",1998,"OTHER","Czechia",8966,21192,26946,57104,-0.860151935094082,-0.214100588400112
"37",1998,"DE","Czechia",84,123,168,375,-0.379489621704904,-0.104
"38",1998,"USA","Czechia",60,67,182,309,-0.109484232841688,-0.0226537216828479
"39",1998,"FR","Czechia",26,18,305,349,0.359374000907897,0.0229226361031519
"40",1998,"RU","Czechia",96,40,86,222,0.868241034232447,0.252252252252252
"41",1998,"UK","Czechia",24,17,47,88,0.336472236621213,0.0795454545454545
"42",1998,"CN","Czechia",16,8,11,35,0.663294217410264,0.228571428571429
"43",1999,"OTHER","Czechia",12755,32349,43226,88330,-0.930636013737859,-0.221827238763727
"44",1999,"RU","Czechia",48,21,39,108,0.81351086280982,0.25
"45",1999,"UK","Czechia",29,22,54,105,0.2708749541354,0.0666666666666667
"46",1999,"DE","Czechia",70,71,106,247,-0.014084739881739,-0.00404858299595142
"47",1999,"USA","Czechia",83,41,128,252,0.699153204620157,0.166666666666667
"48",1999,"FR","Czechia",36,21,77,134,0.529259325454829,0.111940298507463
"49",1999,"CN","Czechia",16,12,14,42,0.27763173659828,0.0952380952380952
"50",2000,"OTHER","Czechia",9180,23950,34830,67960,-0.958907531085624,-0.217333725721012
"51",2000,"DE","Czechia",35,54,117,206,-0.428668005187828,-0.0922330097087379
"52",2000,"UK","Czechia",17,23,46,86,-0.294799540220645,-0.0697674418604651
"53",2000,"FR","Czechia",9,4,37,50,0.747214401830221,0.1
"54",2000,"USA","Czechia",41,16,67,124,0.922333046330118,0.201612903225806
"55",2000,"RU","Czechia",25,10,19,54,0.887303195000903,0.277777777777778
"56",2000,"CN","Czechia",2,5,5,12,-0.78845736036427,-0.25
"57",2001,"OTHER","Czechia",13312,30285,42472,86069,-0.821965606650326,-0.197202244710639
"58",2001,"CN","Czechia",3,7,6,16,-0.762140052046897,-0.25
"59",2001,"FR","Czechia",36,21,77,134,0.529259325454829,0.111940298507463
"60",2001,"UK","Czechia",35,34,70,139,0.0285733724440559,0.00719424460431655
"61",2001,"USA","Czechia",44,28,68,140,0.44558510189759,0.114285714285714
"62",2001,"DE","Czechia",68,80,186,334,-0.161423439156338,-0.0359281437125748
"63",2001,"RU","Czechia",42,38,67,147,0.0988458346366326,0.0272108843537415
"64",2002,"OTHER","Czechia",9943,24877,35577,70397,-0.917044709139761,-0.212139721863148
"65",2002,"DE","Czechia",41,36,91,168,0.128381166648207,0.0297619047619048
"66",2002,"RU","Czechia",26,15,44,85,0.536304709066976,0.129411764705882
"67",2002,"FR","Czechia",28,20,278,326,0.329479201130242,0.0245398773006135
"68",2002,"USA","Czechia",52,30,161,243,0.543086485984212,0.0905349794238683
"69",2002,"UK","Czechia",19,18,53,90,0.0526437334854219,0.0111111111111111
"70",2002,"CN","Czechia",3,1,0,4,0.847297860387204,0.5
"71",2003,"OTHER","Czechia",13789,33272,47249,94310,-0.880823796988792,-0.206584667585622
"72",2003,"USA","Czechia",95,50,256,401,0.63715291120537,0.112219451371571
"73",2003,"UK","Czechia",46,39,60,145,0.163151640686235,0.0482758620689655
"74",2003,"CN","Czechia",2,3,7,12,-0.336472236621213,-0.0833333333333333
"75",2003,"RU","Czechia",40,30,62,132,0.283575290499127,0.0757575757575758
"76",2003,"DE","Czechia",74,113,144,331,-0.421003711535944,-0.117824773413897
"77",2003,"FR","Czechia",66,17,97,180,1.33500106673234,0.272222222222222
"78",2004,"OTHER","Czechia",12769,30674,40376,83819,-0.876372175535545,-0.213615051479975
"79",2004,"FR","Czechia",43,14,53,110,1.09861228866811,0.263636363636364
"80",2004,"USA","Czechia",92,34,162,288,0.986249320481065,0.201388888888889
"81",2004,"RU","Czechia",21,20,34,75,0.0476280489892547,0.0133333333333333
"82",2004,"UK","Czechia",30,34,35,99,-0.123232640423948,-0.0404040404040404
"83",2004,"DE","Czechia",61,59,117,237,0.0330608622608882,0.00843881856540084
"84",2004,"CN","Czechia",5,3,4,12,0.451985123743057,0.166666666666667
"85",2005,"OTHER","Czechia",13858,34745,44331,92934,-0.919151304425768,-0.224750898487098
"86",2005,"USA","Czechia",78,28,124,230,1.01319453751376,0.217391304347826
"87",2005,"UK","Czechia",45,56,95,196,-0.21652831219549,-0.0561224489795918
"88",2005,"RU","Czechia",19,17,33,69,0.108213584640233,0.0289855072463768
"89",2005,"FR","Czechia",65,15,96,176,1.44121011871601,0.284090909090909
"90",2005,"CN","Czechia",23,24,15,62,-0.0416726964005681,-0.0161290322580645
"91",2005,"DE","Czechia",46,89,78,213,-0.654786312687499,-0.2018779342723
"92",2006,"OTHER","Czechia",9499,21752,28298,59549,-0.828489527815585,-0.205763320962569
"93",2006,"DE","Czechia",29,28,62,119,0.0344861760711694,0.00840336134453781
"94",2006,"UK","Czechia",13,17,26,56,-0.259511195485085,-0.0714285714285714
"95",2006,"FR","Czechia",15,5,32,52,1.03609193168678,0.192307692307692
"96",2006,"USA","Czechia",67,32,175,274,0.730887508542792,0.127737226277372
"97",2006,"RU","Czechia",26,19,40,85,0.306730267422475,0.0823529411764706
"98",2006,"CN","Czechia",39,11,42,92,1.23395363653787,0.304347826086957
"99",2007,"OTHER","Czechia",11211,23160,29706,64077,-0.725508204186768,-0.186478767732572
"100",2007,"USA","Czechia",226,112,516,854,0.699791723278614,0.133489461358314
"101",2007,"DE","Czechia",71,113,162,346,-0.462105387221495,-0.121387283236994
"102",2007,"UK","Czechia",33,32,71,136,0.0303053494953288,0.00735294117647059
"103",2007,"FR","Czechia",57,12,60,129,1.52605630349505,0.348837209302326
"104",2007,"RU","Czechia",115,70,148,333,0.493657820143625,0.135135135135135
"105",2007,"CN","Czechia",21,13,9,43,0.465363249689233,0.186046511627907
"106",2008,"OTHER","Czechia",10297,22503,26921,59721,-0.78176970534032,-0.204383717620268
"107",2008,"USA","Czechia",209,107,405,721,0.667232891794475,0.141470180305132
"108",2008,"UK","Czechia",39,23,46,108,0.519300250756963,0.148148148148148
"109",2008,"DE","Czechia",52,59,79,190,-0.125163142954006,-0.0368421052631579
"110",2008,"RU","Czechia",92,52,88,232,0.566395474920801,0.172413793103448
"111",2008,"FR","Czechia",53,20,103,176,0.959256767757598,0.1875
"112",2008,"CN","Czechia",55,46,73,174,0.176930708159078,0.0517241379310345
"113",2009,"OTHER","Czechia",13289,29185,33951,76425,-0.78669776085237,-0.207994766110566
"114",2009,"USA","Czechia",80,69,225,374,0.146930431853771,0.0294117647058824
"115",2009,"CN","Czechia",16,6,7,29,0.931558204004943,0.344827586206897
"116",2009,"DE","Czechia",39,64,92,195,-0.490364551894651,-0.128205128205128
"117",2009,"UK","Czechia",28,26,46,100,0.0727593542824283,0.02
"118",2009,"FR","Czechia",44,23,92,159,0.638488768022081,0.132075471698113
"119",2009,"RU","Czechia",53,28,57,138,0.629777566627356,0.181159420289855
"120",2010,"OTHER","Czechia",10598,23053,27039,60690,-0.777105120062685,-0.205223265776899
"121",2010,"UK","Czechia",45,22,37,104,0.70419701674653,0.221153846153846
"122",2010,"FR","Czechia",28,4,43,75,1.84582669049833,0.32
"123",2010,"DE","Czechia",61,77,68,206,-0.231240761546829,-0.0776699029126214
"124",2010,"USA","Czechia",56,49,118,223,0.132267968577751,0.031390134529148
"125",2010,"RU","Czechia",18,12,28,58,0.392042087776024,0.103448275862069
"126",2010,"CN","Czechia",16,19,34,69,-0.167054084663166,-0.0434782608695652
"127",2011,"OTHER","Czechia",15048,29217,36790,81055,-0.663489526371539,-0.174807229658874
"128",2011,"RU","Czechia",33,37,44,114,-0.112795494145344,-0.0350877192982456
"129",2011,"USA","Czechia",65,36,124,225,0.58473788205276,0.128888888888889
"130",2011,"CN","Czechia",20,20,17,57,0,0
"131",2011,"DE","Czechia",62,125,105,292,-0.697139201829483,-0.215753424657534
"132",2011,"FR","Czechia",48,21,87,156,0.81351086280982,0.173076923076923
"133",2011,"UK","Czechia",42,38,50,130,0.0988458346366326,0.0307692307692308
"134",2012,"OTHER","Czechia",14950,26708,30182,71840,-0.580237122709381,-0.163669265033408
"135",2012,"RU","Czechia",18,22,20,60,-0.195744577126095,-0.0666666666666667
"136",2012,"FR","Czechia",34,9,68,111,1.28966752543082,0.225225225225225
"137",2012,"DE","Czechia",57,135,115,307,-0.857186692516451,-0.254071661237785
"138",2012,"UK","Czechia",28,29,39,96,-0.0344861760711693,-0.0104166666666667
"139",2012,"USA","Czechia",33,28,67,128,0.161641351556416,0.0390625
"140",2012,"CN","Czechia",11,18,19,48,-0.475423696715075,-0.145833333333333
"141",2013,"OTHER","Czechia",8769,16538,18317,43624,-0.634411204028762,-0.178090042178617
"142",2013,"USA","Czechia",13,7,27,47,0.587786664902119,0.127659574468085
"143",2013,"UK","Czechia",12,17,27,56,-0.336472236621213,-0.0892857142857143
"144",2013,"DE","Czechia",38,60,55,153,-0.451985123743057,-0.143790849673203
"145",2013,"FR","Czechia",17,9,268,294,0.610909082322973,0.0272108843537415
"146",2013,"CN","Czechia",8,9,25,42,-0.111225635110224,-0.0238095238095238
"147",2013,"RU","Czechia",14,5,8,27,0.969400557188103,0.333333333333333
"148",2014,"OTHER","Czechia",16232,35331,39382,90945,-0.777759511904834,-0.210006047611194
"149",2014,"USA","Czechia",75,40,151,266,0.622830682142486,0.131578947368421
"150",2014,"UK","Czechia",39,38,35,112,0.0256424306133377,0.00892857142857143
"151",2014,"DE","Czechia",58,149,95,302,-0.93826963859293,-0.301324503311258
"152",2014,"FR","Czechia",27,20,59,106,0.293761118528163,0.0660377358490566
"153",2014,"RU","Czechia",492,204,251,947,0.878926485129287,0.304118268215417
"154",2014,"CN","Czechia",33,41,66,140,-0.214147988405632,-0.0571428571428571
"155",2015,"OTHER","Czechia",17352,34783,41044,93179,-0.695406548178861,-0.187070047972183
"156",2015,"FR","Czechia",75,36,91,202,0.726820395666533,0.193069306930693
"157",2015,"DE","Czechia",128,217,168,513,-0.526269946193464,-0.173489278752437
"158",2015,"CN","Czechia",12,31,36,79,-0.924258901523332,-0.240506329113924
"159",2015,"USA","Czechia",86,56,167,309,0.425903775785438,0.0970873786407767
"160",2015,"UK","Czechia",41,51,57,149,-0.215888380433038,-0.0671140939597315
"161",2015,"RU","Czechia",195,106,127,428,0.607415394275941,0.207943925233645
"162",2016,"OTHER","Czechia",18463,37907,44839,101209,-0.719353171456634,-0.192117301820984
"163",2016,"DE","Czechia",122,270,206,598,-0.792161068301754,-0.247491638795987
"164",2016,"USA","Czechia",105,84,167,356,0.221959418552993,0.0589887640449438
"165",2016,"UK","Czechia",93,158,131,382,-0.527793157022694,-0.170157068062827
"166",2016,"FR","Czechia",73,48,140,261,0.415721608275353,0.0957854406130268
"167",2016,"RU","Czechia",82,64,69,215,0.246133069538909,0.0837209302325581
"168",2016,"CN","Czechia",152,146,201,499,0.0401391675903443,0.0120240480961924
"169",2017,"OTHER","Czechia",15357,29816,35474,80647,-0.663457977500126,-0.179287512244721
"170",2017,"USA","Czechia",148,69,158,375,0.759258205672008,0.210666666666667
"171",2017,"UK","Czechia",61,52,117,230,0.158224005214894,0.0391304347826087
"172",2017,"FR","Czechia",77,51,214,342,0.408696128689611,0.0760233918128655
"173",2017,"DE","Czechia",81,103,103,287,-0.238968592458607,-0.0766550522648084
"174",2017,"CN","Czechia",26,32,14,72,-0.204095356343515,-0.0833333333333333
"175",2017,"RU","Czechia",64,26,47,137,0.88952049080955,0.277372262773723
"176",2018,"OTHER","Czechia",17996,34586,40176,92758,-0.653286137970875,-0.178852497897755
"177",2018,"DE","Czechia",114,168,96,378,-0.386360926798122,-0.142857142857143
"178",2018,"UK","Czechia",45,67,77,189,-0.394415271921579,-0.116402116402116
"179",2018,"FR","Czechia",71,26,331,428,0.992552716707785,0.105140186915888
"180",2018,"RU","Czechia",185,114,130,429,0.482480059053195,0.165501165501166
"181",2018,"CN","Czechia",35,22,16,73,0.456017387270996,0.178082191780822
"182",2018,"USA","Czechia",123,71,193,387,0.54654370636807,0.134366925064599
"183",2020,"OTHER","Czechia",18750,34486,44561,97797,-0.609347524382427,-0.160904731228974
"184",2019,"OTHER","Czechia",21122,38079,47221,106422,-0.589337256539998,-0.159337355058165
"185",2019,"DE","Czechia",107,169,118,394,-0.455362079252788,-0.157360406091371
"186",2019,"FR","Czechia",50,36,110,196,0.324661075692868,0.0714285714285714
"187",2019,"UK","Czechia",88,85,132,305,0.0344861760711694,0.00983606557377049
"188",2019,"CN","Czechia",110,116,90,316,-0.0528757520479478,-0.0189873417721519
"189",2019,"RU","Czechia",136,76,147,359,0.579033873792524,0.167130919220056
"190",2019,"USA","Czechia",76,65,142,283,0.155240598191284,0.03886925795053
"191",2020,"CN","Czechia",171,122,94,387,0.336472236621213,0.126614987080103
"192",2020,"DE","Czechia",140,225,150,515,-0.473112670168933,-0.16504854368932
"193",2020,"FR","Czechia",80,25,96,201,1.14957873226014,0.27363184079602
"194",2020,"USA","Czechia",112,54,143,309,0.724752519975276,0.187702265372168
"195",2020,"UK","Czechia",39,31,44,114,0.226313126075489,0.0701754385964912
"196",2020,"RU","Czechia",185,117,144,446,0.456616548463276,0.152466367713004
"197",2021,"OTHER","Czechia",17067,27000,36571,80638,-0.458679314041084,-0.12318013839629
"198",2021,"CN","Czechia",93,45,47,185,0.720249110337737,0.259459459459459
"199",2021,"UK","Czechia",43,31,51,125,0.322773392263051,0.096
"200",2021,"USA","Czechia",71,43,87,201,0.496936511605324,0.139303482587065
"201",2021,"RU","Czechia",309,172,182,663,0.584560855653236,0.206636500754148
"202",2021,"FR","Czechia",42,18,60,120,0.831733343846092,0.2
"203",2021,"DE","Czechia",89,140,91,320,-0.450968863492991,-0.159375
